{
    "LastUpDate":"19 เม.ย",
    "Data":{"ยุโรป":[0,0,0,0,0,0,0,0,0,0,
                0,0,0,0,0,0,0,0,0,0,0,0,0,0,1,0,0,0,0,0,1,1,1,4,4,2,5,4,8,
                13,12,29,29,47,57,45,147,126,182,241,247,330,284,536,471,622,742,838,1106,1380,1294,1549,2008,2038,2294,2673,2729,2548,3021,3228,
                3502,4523,4191,3980,3056,3548,5019,3958,4774,4417,3484,3092,3248,3995,4683,3888,3753,3801,2460],

            "อเมริกาเหนือ":[0,0,0,0,0,0,0,0,0,0,
                0,0,0,0,0,0,0,0,0,0,0,0,0,0,0,0,0,0,0,0,0,0,0,0,0,0,0,0,1,
                0,5,3,2,1,3,4,3,5,4,9,3,7,10,16,28,30,55,73,72,76,136,188,274,321,361,531,667,528,855,1123,
                1276,1261,1332,1595,1498,1585,2334,2255,2247,2336,2164,1883,1827,2734,2838,2438,2719,2138,1809],

            "อเมริกาใต้":[0,0,0,0,0,0,0,0,0,0,
                0,0,0,0,0,0,0,0,0,0,0,0,0,0,0,0,0,0,0,0,0,0,0,0,0,0,0,0,0,
                0,0,0,0,0,0,1,0,0,0,0,1,2,1,0,0,1,4,5,11,11,16,15,26,22,31,27,42,42,48,74,
                81,135,90,136,73,122,188,189,221,194,138,134,167,263,286,260,261,335,196],

            "เอเชีย":[17,8,16,15,24,26,26,38,43,46,
                45,58,64,66,73,73,86,89,97,108,97,146,122,143,142,106,98,136,117,119,112,99,156,77,59,35,53,59,45,
                59,50,53,51,54,46,53,77,66,87,80,99,107,118,136,147,163,178,173,185,166,181,170,168,197,240,212,212,203,213,256,
                290,298,297,304,309,300,301,291,367,330,370,407,347,374,343,358,1640,335,384],

            "แอฟริกา":[0,0,0,0,0,0,0,0,0,0,
                0,0,0,0,0,0,0,0,0,0,0,0,0,0,0,0,0,0,0,0,0,0,0,0,0,0,0,0,0,
                0,0,0,0,0,0,0,1,0,2,0,3,2,1,1,3,4,7,11,9,15,18,15,16,11,19,26,30,33,20,44,
                46,72,59,53,61,50,65,41,56,106,48,57,48,44,49,67,71,80,63],

            "ออสเตรเลียและโอเชียเนียร์":[0,0,0,0,0,0,0,0,0,0,
                0,0,0,0,0,0,0,0,0,0,0,0,0,0,0,0,0,0,0,0,0,0,0,0,0,0,0,0,0,
                1,0,0,1,0,0,1,0,0,0,0,0,0,0,2,0,0,1,1,0,0,0,0,1,3,2,0,2,3,2,1,
                3,2,3,2,7,8,4,1,1,4,4,3,3,4,2,0,4,5,2]
    },
    "Label":[1,2,3,4,5,6,7,8,9,10,11,12,13,14,15,16,17,18,19,20,21,22,23,24,25,26,27,28,29,30,31,32,33,34,35,36,37,38,39,40,41,42,43,44,45,
        46,47,48,49,50,51,52,53,54,55,56,57,58,59,60,61,62,63,64,65,66,67,68,69,70,71,72,73,74,75,76,77,78,79,80,81,82,83,84,85,86,87,88,89],
        
    "date":["22 ม.ค","23 ม.ค","24 ม.ค","25 ม.ค","26 ม.ค","27 ม.ค","28 ม.ค","29 ม.ค","30 ม.ค","31 ม.ค",
                "1 ก.พ","2 ก.พ","3 ก.พ","4 ก.พ","5 ก.พ","6 ก.พ","7 ก.พ","8 ก.พ","9 ก.พ","10 ก.พ",
                "11 ก.พ","12 ก.พ","13 ก.พ","14 ก.พ","15 ก.พ","16 ก.พ","17 ก.พ","18 ก.พ","19 ก.พ",
                "20 ก.พ","21 ก.พ","22 ก.พ","23 ก.พ","24 ก.พ","25 ก.พ","26 ก.พ","27 ก.พ","28 ก.พ","29 ก.พ",
                "1 มี.ค","2 มี.ค","3 มี.ค","4 มี.ค","5 มี.ค","6 มี.ค","7 มี.ค","8 มี.ค"," มี.ค","10 มี.ค",
                "11 มี.ค","12 มี.ค","13 มี.ค","14 มี.ค","15 มี.ค","16 มี.ค","17 มี.ค","18 มี.ค","19 มี.ค",
                "20 มี.ค","21 มี.ค","22 มี.ค","23 มี.ค","24 มี.ค","25 มี.ค","26 มี.ค","27 มี.ค","28 มี.ค",
                "29 มี.ค","30 มี.ค","31 มี.ค",
                "1 เม.ย","2 เม.ย","3 เม.ย","4 เม.ย","5 เม.ย","6 เม.ย","7 เม.ย","8 เม.ย","9 เม.ย","10 เม.ย",
                "11 เม.ย","12 เม.ย","13 เม.ย","14 เม.ย","15 เม.ย","16 เม.ย","17 เม.ย","18 เม.ย","19 เม.ย"]  
}